11111111111
10000000E01
100000P0001
11111111111