11111111111
1000C00E011
1P000100101
11111111111