11111111111
100P0000001
100001000E1
11111CCC111
11111111111
10011110001
11000111001
11000110011
11111111111