11111111111111111
10000000000000001
100000100000000C1
10000010000000001
1000000000P0000E1
11111111111111111