111111111111111111111111111111
100000000000000000000000000001
100000000000000000000000000001
10000010000000000000C000E00001
100000100000000000000000000001
100000000000000000000000000001
100000000000000000000000000001
100000000000000000000000000001
100000000000010000000000000001
100000000000010000000000000001
10000000000000000C000000000001
1000000P0000000000000000100001
100000000000000000000000100001
100000000000000000000000000001
100000000000000000000C00000001
111111111111111111111111111111