11111111111
1000C000E01
1P000100001
11111CCC111
11111111111
11111111111
11111111111
11111111111
11111111111