111111111111111111111111111111
1C00100010001000100010100010C1
111P10000010001000100000100011
100010111111110000111C00010001
101110100000000001111100111001
101C10101101100000111001111101
10001E10100C100000000000000001
110111101111100000000001111001
110000000000000011110000001001
101100111111111111C1000001C1E1
100000000000010101011001110111
101111111011010001000000110001
101000C11011010100010100110001
101011111011010111111110000001
1C1000000000000000000C10000001
111111111111111111111111111111