11111111111
111C000C1E1
1P001110001
11111111111