11111111111
10C00000001
100000P0001
11111111111