111111111
10P000001
111111101
100C00001
101111111
100C00C01
111111101
1000C0001
101111111
1C00000E1
111111111