11111111111
10C00000E01
100000P0001
11111111111