11111111111111111111


1E0000000000000C0001
10100101001000001001
10100100101010100001






1P0000000C00C00000C1
100000000C00C00000C1
11111111111111111111