1111111
101
1111111111111
101
1111111111111
101
1111111111111
101
1111111111111
101
1111111111111
101
1111111111111
101
1111111111111
101
1111111111111
101
1111111111111
101
1111111111111
101
1111111111111
101
1111111111111
101
1111111111111
101
1111111111111
101
1111111111111
101
1111111111111
101
1111111111111
101
1111111111111
101
1111111111111
101
1111111111111
101
1111111111111
101
1111111111111
101
1111111111111
101
1111111111111
101
1111111111111
101
1111111111111
101
1111111111111
101
1111111111111
101
1111111111111
101
1111111111111
101
1111111111111
101
1111111111111
101
1111111111111
101
1111111111111
101
1111111111111
101
1111111111111
101
1111111111111
101
1111111111111
101
1111111111111
101
1111111111111
101
1111111111111
101
1111111111111
101
1111111111111
101
1111111111111
101
1111111111111
101
1111111111111
101
1111111111111
101
1111111111111
101
1111111111111
101
1111111111111
101
1111111111111
101
1111111111111
101
1111111111111
101
1111111111111
101
1111111111111
101
1111111111111
101
1111111111111
101
1111111111111
101
1111111111111
101
1111111111111
101
1111111111111
101
1111111111111
101
1111111111111
101
1111111111111
101
1111111111111
101
1111111111111
101
1111111111111
101
1111111111111
101
1111111111111
101
1111111111111
101
1111111111111
101
1111111111111
101
1111111111111
101
1111111111111
101
1111111111111
101
1111111111111
101
1111111111111
101
1111111111111
101
1111111111111
101
1111111111111
101
1111111111111
101
1111111111111
101
1111111111111
101
1111111111111
101
1111111111111
101
1111111111111
101
1111111111111
101
1111111111111
101
1111111111111
101
1111111111111
101
1111111111111
101
1111111111111
101
1111111111111
101
1111111111111
101
1111111111111
101
1111111111111
101
1111111111111
101
1111111111111
101
1111111111111
101
1111111111111
101
1111111111111
101
1111111111111
101
1111111111111
101
1111111111111
101
1111111111111
101
1111111111111
101
1111111111111
101
1111111111111
101
1111111111111
101
1111111111111
101
1111111111111
101
1111111111111
101
1111111111111
101
1111111111111
101
1111111111111
101
1111111111111
101
1111111111111
101
1111111111111
101
1111111111111
101
1111111111111
101
1111111111111
101
1111111111111
101
1111111111111
101
1111111111111
101
1111111111111
101
1111111111111
101
1111111111111
101
1111111111111
101
1111111111111
101
1111111111111
101
1111111111111
101
1111111111111
101
1111111111111
101
1111111111111
101
1111111111111
101
1111111111111
101
1111111111111
101
1111111111111
101
1111111111111
101
1111111111111
101
1111111111111
101
1111111111111
101
1111111111111
101
1111111111111
101
1111111111111
101
1111111111111
101
1111111111111
101
1111111111111
101
1111111111111
101
1111111111111
101
1111111111111
101
1111111111111
101
1111111111111
101
1111111111111
101
1111111111111
101
1111111111111
101
1111111111111
101
1111111111111
101
1111111111111
101
1111111111111
101
1111111111111
101
1111111111111
101
1111111111111
101
1111111111111
101
1111111111111
101
1111111111111
101
1111111111111
101
1111111111111
101
1111111111111
101
1111111111111
101
1111111111111
101
1111111111111
101
1111111111111
101
1111111111111
101
1111111111111
101
1111111111111
101
1111111111111
101
1111111111111
101
1111111111111
101
1111111111111
101
1111111111111
101
1111111111111
101
1111111111111
101
1111111111111
101
1111111111111
101
1111111111111
101
1111111111111
101
1111111111111
101
1111111111111
101
1111111111111
101
1111111111111
101
1111111111111
101
1111111111111
101
1111111111111
101
1111111111111
101
1111111111111
101
1111111111111
101
1111111111111
101
1111111111111
101
1111111111111
101
1111111111111
101
1111111111111
101
1111111111111
101
1111111111111
101
1111111111111
101
1111111111111
101
1111111111111
101
1111111111111
101
1111111111111
101
1111111111111
101
1111111111111
101
1111111111111
101
1111111111111
101
1111111111111
101
1111111111111
101
1111111111111
101
1111111111111
101
1111111111111
101
1111111111111
101
1111111111111
101
1111111111111
101
1111111111111
101
1111111111111
101
1111111111111
101
1111111111111
101
1111111111111
101
1111111111111
101
1111111111111
101
1111111111111
101
1111111111111
101
1111111111111
101
1111111111111
101
1111111111111
101
1111111111111
101
1111111111111
101
1111111111111
101
1111111111111
101
1111111111111
101
1111111111111
101
1111111111111
101
1111111111111
101
1111111111111
101
1111111111111
101
1111111111111
101
1111111111111
101
1111111111111
101
1111111111111
101
1111111111111
101
1111111111111
101
1111111111111
101
1111111111111
101
1111111111111
101
1111111111111
101
1111111111111
101
1111111111111
101
1111111111111
101
1111111111111
101
1111111111111
101
1111111111111
101
1111111111111
101
1111111111111
101
1111111111111
101
1111111111111
101
1111111111111
101
1111111111111
101
1111111111111
101
1111111111111
101
1111111111111
101
1111111111111
101
1111111111111
101
1111111111111
101
1111111111111
101
1111111111111
101
1111111111111
101
1111111111111
101
1111111111111
101
1111111111111
101
1111111111111
101
1111111111111
101
1111111111111
101
1111111111111
101
1111111111111
101
1111111111111
101
1111111111111
101
1111111111111
101
1111111111111
101
1111111111111
101
1111111111111
101
1111111111111
101
1111111111111
101
1111111111111
101
1111111111111
101
1111111111111
101
1111111111111
101
1111111111111
101
1111111111111
101
1111111111111
101
1111111111111
101
1111111111111
101
1111111111111
101
1111111111111
101
1111111111111
101
1111111111111
101
1111111111111
101
1111111111111
101
1111111111111
101
1111111111111
101
1111111111111
101
1111111111111
101
1111111111111
101
1111111111111
101
1111111111111
101
1111111111111
101
1111111111111
101
1111111111111
101
1111111111111
101
1111111111111
101
1111111111111
101
1111111111111
101
1111111111111
101
1111111111111
101
1111111111111
101
1111111111111
101
1111111111111
101
1111111111111
101
1111111111111
101
1111111111111
101
1111111111111
101
1111111111111
101
1111111111111
101
1111111111111
101
1111111111111
101
1111111111111
101
1111111111111
101
1111111111111
101
1111111111111
101
1111111111111
101
1111111111111
101
1111111111111
101
1111111111111
101
1111111111111
101
1111111111111
101
1111111111111
101
1111111111111
101
1111111111111
101
1111111111111
101
1111111111111
101
1111111111111
101
1111111111111
101
1111111111111
101
1111111111111
101
1111111111111
101
1111111111111
101
1111111111111
101
1111111111111
101
1111111111111
101
1111111111111
101
1111111111111
101
1111111111111
101
1111111111111
101
1111111111111
101
1111111111111
101
1111111111111
101
1111111111111
101
1111111111111
101
1111111111111
101
1111111111111
101
1111111111111
101
1111111111111
101
1111111111111
101
1111111111111
101
1111111111111
101
1111111111111
101
1111111111111
101
1111111111111
101
1111111111111
101
1111111111111
101
1111111111111
101
1111111111111
101
1111111111111
101
1111111111111
101
1111111111111
101
1111111111111
101
1111111111111
101
1111111111111
101
1111111111111
101
1111111111111
101
1111111111111
101
1111111111111
101
1111111111111
101
1111111111111
101
1111111111111
101
1111111111111
101
1111111111111
101
1111111111111
101
1111111111111
101
1111111111111
101
1111111111111
101
1111111111111
101
1111111111111
101
1111111111111
101
1111111111111
101
1111111111111
101
1111111111111
101
1111111111111
101
1111111111111
101
1111111111111
101
1111111111111
101
1111111111111
101
1111111111111
101
1111111111111
101
1111111111111
101
1111111111111
101
1111111111111
101
1111111111111
101
1111111111111
101
1111111111111
101
1111111111111
101
1111111111111
101
1111111111111
101
1111111111111
101
1111111111111
101
1111111111111
101
1111111111111
101
1111111111111
101
1111111111111
101
1111111111111
101
1111111111111
101
1111111111111
101
1111111111111
101
1111111111111
101
1111111111111
101
1111111111111
101
1111111111111
101
1111111111111
101
1111111111111
101
1111111111111
101
1111111111111
101
1111111111111
101
1111111111111
101
1111111111111
101
1111111111111
101
1111111111111
101
1111111111111
101
1111111111111
101
1111111111111
101
1111111111111
101
1111111111111
101
1111111111111
101
1111111111111
101
1111111111111
101
1111111111111
101
1111111111111
101
1111111111111
101
1111111111111
101
1111111111111
101
1111111111111
101
1111111111111
101
1111111111111
101
1111111111111
101
1111111111111
101
1111111111111
101
1111111111111
101
1111111111111
101
1111111111111
101
1111111111111
101
1111111111111
101
1111111111111
101
1111111111111
101
1111111111111
101
1111111111111
101
1111111111111
101
1111111111111
101
1111111111111
101
1111111111111
101
1111111111111
101
1111111111111
101
1111111111111
101
1111111111111
101
1111111111111
101
1111111111111
101
1111111111111
101
1111111111111
101
1111111111111
101
1111111111111
101
1111111111111
101
1111111111111
101
1111111111111
101
1111111111111
101
1111111111111
101
1111111111111
101
1111111111111
101
1111111111111
101
1111111111111
101
1111111111111
101
1111111111111
101
1111111111111
101
1111111111111
101
1111111111111
101
1111111111111
101
1111111111111
101
1111111111111
101
1111111111111
101
1111111111111
101
1111111111111
101
1111111111111
101
1111111111111
101
1111111111111
101
1111111111111
101
1111111111111
101
1111111111111
101
1111111111111
101
1111111111111
101
1111111111111
101
1111111111111
101
1111111111111
101
1111111111111
101
1111111111111
101
1111111111111
101
1111111111111
101
1111111111111
101
1111111111111
101
1111111111111
101
1111111111111
101
1111111111111
101
1111111111111
101
1111111111111
101
1111111111111
101
1111111111111
101
1111111111111
101
1111111111111
101
1111111111111
101
1111111111111
101
1111111111111
101
1111111111111
101
1111111111111
101
1111111111111
101
1111111111111
101
1111111111111
101
1111111111111
101
1111111111111
101
1111111111111
101
1111111111111
101
1111111111111
101
1111111111111
101
1111111111111
101
1111111111111
101
1111111111111
101
1111111111111
101
1111111111111
101
1111111111111
101
1111111111111
101
1111111111111
101
1111111111111
101
1111111111111
101
1111111111111
101
1111111111111
101
1111111111111
101
1111111111111
101
1111111111111
101
1111111111111
101
1111111111111
101
1111111111111
101
1111111111111
101
1111111111111
101
1111111111111
101
1111111111111
101
1111111111111
101
1111111111111
101
1111111111111
101
1111111111111
101
1111111111111
101
1111111111111
101
1111111111111
101
1111111111111
101
1111111111111
101
1111111111111
101
1111111111111
101
1111111111111
101
1111111111111
101
1111111111111
101
1111111111111
101
1111111111111
101
1111111111111
101
1111111111111
101
1111111111111
101
1111111111111
101
1111111111111
101
1111111111111
101
1111111111111
101
1111111111111
101
1111111111111
101
1111111111111
101
1111111111111
101
1111111111111
101
1111111111111
101
1111111111111
101
1111111111111
101
1111111111111
101
1111111111111
101
1111111111111
101
1111111111111
101
1111111111111
101
1111111111111
101
1111111111111
101
1111111111111
101
1111111111111
101
1111111111111
101
1111111111111
101
1111111111111
101
1111111111111
101
1111111111111
101
1111111111111
101
1111111111111
101
1111111111111
101
1111111111111
101
1111111111111
101
1111111111111
101
1111111111111
101
1111111111111
101
1111111111111
101
1111111111111
101
1111111111111
101
1111111111111
101
1111111111111
101
1111111111111
101
1111111111111
101
1111111111111
101
1111111111111
101
1111111111111
101
1111111111111
101
1111111111111
101
1111111111111
101
1111111111111
101
1111111111111
101
1111111111111
101
1111111111111
101
1111111111111
101
1111111111111
101
1111111111111
101
1111111111111
101
1111111111111
101
1111111111111
101
1111111111111
101
1111111111111
101
1111111111111
101
1111111111111
101
1111111111111
101
1111111111111
101
1111111111111
101
1111111111111
101
1111111111111
101
1111111111111
101
1111111111111
101
1111111111111
101
1111111111111
101
1111111111111
101
1111111111111
101
1111111111111
101
1111111111111
101
1111111111111
101
1111111111111
101
1111111111111
101
1111111111111
101
1111111111111
101
1111111111111
101
1111111111111
101
1111111111111
101
1111111111111
101
1111111111111
101
1111111111111
101
1111111111111
101
1111111111111
101
1111111111111
101
1111111111111
101
1111111111111
101
1111111111111
101
1111111111111
101
1111111111111
101
1111111111111
101
1111111111111
101
1111111111111
101
1111111111111
101
1111111111111
101
1111111111111
101
1111111111111
101
1111111111111
101
1111111111111
101
1111111111111
101
1111111111111
101
1111111111111
101
1111111111111
101
1111111111111
101
1111111111111
101
1111111111111
101
1111111111111
101
1111111111111
101
1111111111111
101
1111111111111
101
1111111111111
101
1111111111111
101
1111111111111
101
1111111111111
101
1111111111111
101
1111111111111
101
1111111111111
101
1111111111111
101
1111111111111
101
1111111111111
101
1111111111111
101
1111111111111
101
1111111111111
101
1111111111111
101
1111111111111
101
1111111111111
101
1111111111111
101
1111111111111
101
1111111111111
101
1111111111111
101
1111111111111
101
1111111111111
101
1111111111111
101
1111111111111
101
1111111111111
101
1111111111111
101
1111111111111
101
1111111111111
101
1111111111111
101
1111111111111
101
1111111111111
101
1111111111111
101
1111111111111
101
1111111111111
101
1111111111111
101
1111111111111
101
1111111111111
101
1111111111111
101
1111111111111
101
1111111111111
101
1111111111111
101
1111111111111
101
1111111111111
101
1111111111111
101
1111111111111
101
1111111111111
101
1111111111111
101
1111111111111
101
1111111111111
101
1111111111111
101
1111111111111
101
1111111111111
101
1111111111111
101
1111111111111
101
1111111111111
101
1111111111111
101
1111111111111
101
1111111111111
101
1111111111111
101
1111111111111
101
1111111111111
101
1111111111111
101
1111111111111
101
1111111111111
101
1111111111111
101
1111111111111
101
1111111111111
101
1111111111111
101
1111111111111
101
1111111111111
101
1111111111111
101
1111111111111
101
1111111111111
101
1111111111111
101
1111111111111
101
1111111111111
101
1111111111111
101
1111111111111
101
1111111111111
101
1111111111111
101
1111111111111
101
1111111111111
101
1111111111111
101
1111111111111
101
1111111111111
101
1111111111111
101
1111111111111
101
1111111111111
101
1111111111111
101
1111111111111
101
1111111111111
101
1111111111111
101
1111111111111
101
1111111111111
101
1111111111111
101
1111111111111
101
1111111111111
101
1111111111111
101
1111111111111
101
1111111111111
101
1111111111111
101
1111111111111
101
1111111111111
101
1111111111111
101
1111111111111
101
1111111111111
101
1111111111111
101
1111111111111
101
1111111111111
101
1111111111111
101
1111111111111
101
1111111111111
101
1111111111111
101
1111111111111
101
1111111111111
101
1111111111111
101
1111111111111
101
1111111111111
101
1111111111111
101
1111111111111
101
1111111111111
101
1111111111111
101
1111111111111
101
1111111111111
101
1111111111111
101
1111111111111
101
1111111111111
101
1111111111111
101
1111111111111
101
1111111111111
101
1111111111111
101
1111111111111
101
1111111111111
101
1111111111111
101
1111111111111
101
1111111111111
101
1111111111111
101
1111111111111
101
1111111111111
101
1111111111111
101
1111111111111
101
1111111111111
101
1111111111111
101
1111111111111
101
1111111111111
101
1111111111111
101
1111111111111
101
1111111111111
101
1111111111111
101
1111111111111
101
1111111111111
101
1111111111111
101
1111111111111
101
1111111111111
101
1111111111111
101
1111111111111
101
1111111111111
101
1111111111111
101
1111111111111
101
1111111111111
101
1111111111111
101
1111111111111
101
1111111111111
101
1111111111111
101
1111111111111
101
1111111111111
101
1111111111111
101
1111111111111
101
1111111111111
101
1111111111111
101
1111111111111
101
1111111111111
101
1111111111111
101
1111111111111
101
1111111111111
101
1111111111111
101
1111111111111
101
1111111111111
101
1111111111111
101
1111111111111
101
1111111111111
101
1111111111111
101
1111111111111
101
1111111111111
101
1111111111111
101
1111111111111
101
1111111111111
101
1111111111111
101
1111111111111
101
1111111111111
101
1111111111111
101
1111111111111
101
1111111111111
101
1111111111111
101
1111111111111
101
1111111111111
101
1111111111111
101
1111111111111
101
1111111111111
101
1111111111111
101
1111111111111
101
1111111111111
101
1111111111111
101
1111111111111
101
1111111111111
101
1111111111111
101
1111111111111
101
1111111111111
101
1111111111111
101
1111111111111
101
1111111111111
101
1111111111111
101
1111111111111
101
1111111111111
101
1111111111111
101
1111111111111
101
1111111111111
101
1111111111111
101
1111111111111
101
1111111111111
101
1111111111111
101
1111111111111
101
1111111111111
101
1111111111111
101
1111111111111
101
1111111111111
101
1111111111111
101
1111111111111
101
1111111111111
101
1111111111111
101
1111111111111
101
1111111111111
101
1111111111111
101
1111111111111
101
1111111111111
101
1111111111111
101
1111111111111
101
1111111111111
101
1111111111111
101
1111111111111
101
1111111111111
101
1111111111111
101
1111111111111
101
1111111111111
101
1111111111111
101
1111111111111
101
1111111111111
101
1111111111111
101
1111111111111
101
1111111111111
101
1111111111111
101
1111111111111
101
1111111111111
101
1111111111111
101
1111111111111
101
1111111111111
101
1111111111111
101
1111111111111
101
1111111111111
101
1111111111111
101
1111111111111
101
1111111111111
101
1111111111111
101
1111111111111
101
1111111111111
101
1111111111111
101
1111111111111
101
1111111111111
101
1111111111111
101
1111111111111
101
1111111111111
101
1111111111111
101
1111111111111
101
1111111111111
101
1111111111111
101
1111111111111
101
1111111111111
101
1111111111111
101
1111111111111
101
1111111111111
101
1111111111111
101
1111111111111
101
1111111111111
101
1111111111111
101
1111111111111
101
1111111111111
101
1111111111111
101
1111111111111
101
1111111111111
101
1111111111111
101
1111111111111
101
1111111111111
101
1111111111111
101
1111111111111
101
1111111111111
101
1111111111111
101
1111111111111
101
1111111111111
101
1111111111111
101
1111111111111
101
1111111111111
101
1111111111111
101
1111111111111
101
1111111111111
101
1111111111111
101
1111111111111
101
1111111111111
101
1111111111111
101
1111111111111
101
1111111111111
101
1111111111111
101
1111111111111
101
1111111111111
101
1111111111111
101
1111111111111
101
1111111111111
101
1111111111111
101
1111111111111
101
1111111111111
101
1111111111111
101
1111111111111
101
1111111111111
101
1111111111111
101
1111111111111
101
1111111111111
101
1111111111111
101
1111111111111
101
1111111111111
101
1111111111111
101
1111111111111
101
1111111111111
101
1111111111111
101
1111111111111
101
1111111111111
101
1111111111111
101
1111111111111
101
1111111111111
101
1111111111111
101
1111111111111
101
1111111111111
101
1111111111111
101
1111111111111
101
1111111111111
101
1111111111111
101
1111111111111
101
1111111111111
101
1111111111111
101
1111111111111
101
1111111111111
101
1111111111111
101
1111111111111
101
1111111111111
101
1111111111111
101
1111111111111
101
1111111111111
101
1111111111111
101
1111111111111
101
1111111111111
101
1111111111111
101
1111111111111
101
1111111111111
101
1111111111111
101
1111111111111
101
1111111111111
101
1111111111111
101
1111111111111
101
1111111111111
101
1111111111111
101
1111111111111
101
1111111111111
101
1111111111111
101
1111111111111
101
1111111111111
101
1111111111111
101
1111111111111
101
1111111111111
101
1111111111111
101
1111111111111
101
1111111111111
101
1111111111111
101
1111111111111
101
1111111111111
101
1111111111111
101
1111111111111
101
1111111111111
101
1111111111111
101
1111111111111
101
1111111111111
101
1111111111111
101
1111111111111
101
1111111111111
101
1111111111111
101
1111111111111
101
1111111111111
101
1111111111111
101
1111111111111
101
1111111111111
101
1111111111111
101
1111111111111
101
1111111111111
101
1111111111111
101
1111111111111
101
1111111111111
101
1111111111111
101
1111111111111
101
1111111111111
101
1111111111111
101
1111111111111
101
1111111111111
101
1111111111111
101
1111111111111
101
111111
