111111
100001
100001
10P001
1E0001
111111