111111
10C001
000001
10P001
1E0001
111111