111111
10C001
100001
10P001
1E0001
110111