111111
10C001
100001
10P001
100001
111111