111111
10C001
100001
100001
1E0001
111111