111111111
100000001
10000E001
100000001
100P00001
100000001
100000001
100000001
100000001
100000001
100000001
100000001
100000001
100000001
100000001
10000C001
111111111