11111111111
10C00000E01
10000000001
11111111111