11111111111
10C00000E011
100000P0000
11111111111